#Testis	tes
#Brain - Anterior cingulate cortex (BA24)	ban
#Brain - Caudate (basal ganglia)	bca
#Brain - Cerebellar Hemisphere	bceh
#Brain - Cerebellum	bce
#Brain - Cortex	bco
#Brain - Frontal Cortex (BA9)	bfr
#Brain - Hippocampus	bhi
#Brain - Hypothalamus	bhy
#Brain - Nucleus accumbens (basal ganglia)	bnu
#Brain - Putamen (basal ganglia)	bpu
#Adrenal Gland	ag
#Cells - EBV-transformed lymphocytes	ebv
#Cells - Transformed fibroblasts	fib
#Heart - Atrial Appendage	haa
#Heart - Left Ventricle	hlv
#Liver	liv
#Muscle - Skeletal	ms
#Ovary	ov
#Pancreas	pan
#Pituitary	pit
#Prostate	pro
#Small Intestine - Terminal Ileum	si
#Spleen	spl
#Uterus	ut
#Vagina	va
#Whole Blood	wb
#Skin - Not Sun Exposed (Suprapubic)	snse
#Skin - Sun Exposed (Lower leg)	sse
#Colon - Sigmoid	cols
#Colon - Transverse	colt
#Thyroid	thy
#Esophagus - Gastroesophageal Junction	esog
#Esophagus - Mucosa	esom
#Esophagus - Muscularis	esomu
#Artery - Coronary	ac
#Artery - Aorta	aa
#Artery - Tibial	at
#Stomach	sto
#Lung	lu
#Adipose - Visceral (Omentum)	av
#Adipose - Subcutaneous	as
#Breast - Mammary Tissue	br
#Nerve - Tibial	nt
#####Bladder    bl
#####Minor Salivary Gland   msg
#####Kidney - Cortex    kc
#####Cervix - Ectocervix    ect
#####Cervix - Endocervix end####Cells - Leukemia cell line (CML)    leu
#####Brain - Spinal cord (cervical c-1) bsp
#####Brain - Substantia nigra   bsu
#####Brain - Amygdala   bam
#####Fallopian Tube ft
#Artery - Aorta	aa
#Adipose - Subcutaneous	as
#Artery - Tibial	at
#Esophagus - Mucosa	esom
#Esophagus - Muscularis	esomu
#Cells - Transformed fibroblasts	fib
#Lung	lu
Muscle - Skeletal	ms
#Nerve - Tibial	nt
#Skin - Sun Exposed (Lower leg)	sse
#Thyroid	thy
#Whole Blood	wb
# aa 197
# as 298
# at 285
# esom 241
# esomu 218
# fib 272
# lu 278
# ms 361
# nt 256
# sse 302
# thy 278
# wb 338